Reading Exercise (Pinyin)
--------------------

Zuótiān wǎnshang, wǒ hé péngyou qùle yī jiā zhōngguó cāntīng. Zhè jiā cāntīng hěn yǒumíng, cài hěn hǎochī. Wǒmen diǎnle běijīng kǎoyā, gōngbǎo jīdīng hé dàn chǎofàn. Fúwùyuán tuījiàn wǒmen chángshì tāmen de tèsè chá. Fàn hòu, wǒmen hái chīle tiándiǎn. Zhè dùn fàn zǒnggòng huāle sānbǎi yuán.

生词表 / Vocabulary
--------------------

• zuótiān (昨天) - yesterday
• péngyou (朋友) - friend
• cāntīng (餐厅) - restaurant
• yǒumíng (有名) - famous
• cài (菜) - dish, food
• hǎochī (好吃) - delicious
• diǎn (点) - to order
• běijīng kǎoyā (北京烤鸭) - Peking duck
• gōngbǎo jīdīng (宫保鸡丁) - Kung Pao chicken
• dàn chǎofàn (蛋炒饭) - egg fried rice
• fúwùyuán (服务员) - waiter
• tuījiàn (推荐) - to recommend
• tèsè (特色) - special, characteristic
• fàn hòu (饭后) - after meal
• tiándiǎn (甜点) - dessert
• zǒnggòng (总共) - in total
• huā (花) - to spend (money)
• yuán (元) - yuan (Chinese currency)


理解问题 / Comprehension Questions
------------------------------

【Question 1】 Tāmen qùle shénme dìfang?
Answer: 他们去了一家中国餐厅。

【Question 2】 Tāmen diǎnle shénme cài?
Answer: 他们点了北京烤鸭、宫保鸡丁和蛋炒饭。

【Question 3】 Zhè dùn fàn huāle duōshao qián?
Answer: 这顿饭总共花了三百元。

